111111111111111
100001000000001
100001000000001
100000000000001
100000000100001
111110000100001
100000000100001
100001111100001
100001000000001
100001000000001
111111111111111