111111111111111
100001200000021
100001000000001
100000000000001
120000000100001
111110000100001
100000200100001
100001111100001
102201220000301
102201220000001
111111111111111